简	簡
单	單
选	選
决	決
择	擇
实	實
们	們
亲	親
试	試
着	著
给	給
见	見
后	後
还	還
当	當
买	買
来	來
热	熱
妈	媽
负	負
责	責
晓	曉
带	帶
运	運
则	則
电	電
视	視
这	這
游	遊
于	於
轻	輕
动	動
怀	懷
为	為
诉	訴
说	說
么	麼
会	會
与	與
样	樣
数	數
论	論
应	應
罢	罷
学	學
类	類
镜	鏡
连	連
锁	鎖
体	體
线	線
竞	競
争	爭
价	價
货	貨
购	購
乐	樂
开	開
录	錄
导	導
时	時
节	節
经	經
纲	綱
借	藉
个	個
历	歷
资	資
编	編
观	觀
众	眾
启	啟
传	傳
闻	聞
装	裝
认	認
谷	穀
杂	雜
粮	糧
长	長
万	萬
岂	豈
无	無
对	對
广	廣
该	該
剧	劇
两	兩
独	獨
红	紅
罗	羅
写	寫
几	幾
参	參
关	關
语	語
陈	陳
杰	傑
义	義
国	國
黄	黃
艳	艷
专	專
横	橫
乱	亂
伦	倫
怜	憐
设	設
计	計
检	檢
统	統
进	進
间	間
讯	訊
发	發
够	夠
医	醫
献	獻
军	軍
领	領
庄	莊
园	園
并	並
图	圖
强	強
联	聯
队	隊
击	擊
溃	潰
团	團
制	製
张	張
辑	輯
闲	閑
兴	興
奋	奮
将	將
种	種
达	達
谱	譜
维	維
纳	納
纽	紐
约	約
挥	揮
爱	愛
云	雲
缇	緹
饰	飾
潜	潛
静	靜
华	華
现	現
叶	葉
丽	麗
创	創
吴	呉
汤	湯
辫	辮
嘱	囑
战	戰
冢	塚
壮	壯
级	級
测	測
尔	爾
标	標
记	記
杨	楊
宁	寧
伤	傷
龙	龍
书	書
宝	寶
剑	劍
丢	丟
门	門
汉	漢
办	辦
务	務
总	總
习	習
杀	殺
贺	賀
终	終
识	識
声	聲
没	沒
颗	顆
让	讓
变	變
号	號
临	臨
铺	鋪
较	較
纪	紀
占	佔
积	積
组	組
织	織
奥	奧
济	濟
马	馬
卢	盧
际	際
币	幣
问	問
题	題
别	別
机	機
赖	賴
费	費
败	敗
圣	聖
麦	麥
却	卻
惧	懼
苏	蘇
馆	館
区	區
只	隻
极	極
鹅	鵝
侣	侶
协	協
抚	撫
养	養
鸟	鳥
许	許
诸	諸
阵	陣
营	營
练	練
员	員
库	庫
险	險
场	場
东	東
处	處
鱼	魚
岛	島
湾	灣
栋	棟
汇	匯
换	換
断	斷
扩	擴
产	産
过	過
层	層
坏	壞
铑	銠
称	稱
稳	穩
温	溫
点	點
钒	釩
剂	劑
镇	鎮
辖	轄
寻	尋
卫	衛
滚	滾
档	檔
栏	欄
双	雙
娱	娛
尝	嘗
亚	亞
系	係
岁	歲
宫	宮
胜	勝
欧	歐
欢	歡
坛	壇
属	屬
锡	錫
它	牠
颌	頜
归	歸
离	離
碱	鹼
质	質
讲	講
恋	戀
栖	棲
农	農
敌	敵
吓	嚇
议	議
权	權
远	遠
纹	紋
盖	蓋
旧	舊
须	須
驻	駐
礼	禮
志	誌
摄	攝
术	術
里	裡
师	師
边	邊
话	話
条	條
确	確
余	餘
况	況
规	規
减	減
从	從
划	劃
项	項
铁	鐵
赛	賽
响	響
词	詞
兹	茲
贝	貝
楼	樓
遗	遺
迹	蹟
兰	蘭
顿	頓
县	縣
课	課
脑	腦
宽	寬
频	頻
鸥	鷗
网	網
亩	畝
举	舉
签	簽
意	義
钢	鋼
丰	豐
沪	滬
扬	揚
誉	譽
内	內
车	車
苹	蘋
陆	陸
舰	艦
业	業
筑	築
轮	輪
忧	憂
笔	筆
帅	帥
夺	奪
恒	恆
锰	錳
矿	礦
赞	贊
验	驗
丝	絲
据	據
结	結
侧	側
摊	攤
乔	喬
亿	億
构	構
采	採
焕	煥
释	釋
满	滿
贯	貫
顶	頂
回	迴
评	評
戏	戲
画	畫
随	隨
荣	榮
综	綜
额	額
偿	償
骗	騙
丑	醜
职	職
辞	辭
审	審
惯	慣
谈	談
气	氣
周	週
涡	渦
邓	鄧
训	訓
户	戶
桥	橋
辆	輛
头	頭
乡	鄉
阳	陽
辽	遼
显	顯
风	風
范	範
围	圍
绸	綢
瞩	矚
纺	紡
颠	顛
蚕	蠶
请	請
肃	肅
报	報
卧	臥
护	護
严	嚴
鸿	鴻
赓	賡
吕	呂
缅	緬
蛮	蠻
细	細
幸	倖
阁	閣
毕	畢
蕴	蘊
拟	擬
订	訂
调	調
损	損
党	黨
征	徵
钟	鐘
坚	堅
滤	濾
违	違
刘	劉
银	銀
获	獲
备	備
谴	譴
销	銷
邮	郵
儿	兒
讦	訐
挟	挾
俩	倆
贿	賄
鲜	鮮
届	屆
劲	勁
谋	謀
郑	鄭
访	訪
岗	崗
丧	喪
萨	薩
乌	烏
鉴	鑑
匀	勻
墙	牆
浆	漿
复	復
准	準
注	註
禄	祿
袭	襲
疗	療
预	預
烟	煙
疯	瘋
蚀	蝕
异	異
肾	腎
垒	壘
惨	慘
阴	陰
啮	齧
齿	齒
愿	願
转	轉
恶	惡
顺	順
针	針
续	續
赠	贈
诞	誕
势	勢
难	難
残	殘
榄	欖
艺	藝
灭	滅
玑	璣
祸	禍
迁	遷
泽	澤
玛	瑪
摆	擺
脱	脫
缚	縛
隐	隱
误	誤
每	毎
驶	駛
渐	漸
轨	軌
轴	軸
环	環
绕	繞
绝	絕
辟	闢
鹤	鶴
觉	覺
码	碼
镒	鎰
骑	騎
状	狀
弃	棄
尽	盡
赢	贏
锦	錦
帮	幫
饶	饒
监	監
蓝	藍
贪	貪
灾	災
鲁	魯
犹	猶
庙	廟
讨	討
氢	氫
键	鍵
沟	溝
晋	晉
庆	慶
隶	隸
干	乾
优	優
冻	凍
纵	縱
肤	膚
湿	濕
树	樹
厅	廳
绩	績
铜	銅
触	觸
弹	彈
凯	凱
岳	嶽
紧	緊
邻	鄰
继	繼
励	勵
斗	鬥
抢	搶
绘	繪
齐	齊
废	廢
彻	徹
厦	廈
唤	喚
仪	儀
递	遞
巩	鞏
龄	齡
诺	諾
斋	齋
弥	彌
莱	萊
胁	脅
沈	瀋
锋	鋒
纣	紂
峡	峽
轰	轟
证	證
韦	韋
闭	閉
恪	愙
鳄	鱷
布	佈
逊	遜
阅	閱
读	讀
册	冊
辅	輔
诗	詩
译	譯
苍	蒼
扑	撲
圆	圓
径	徑
鲫	鯽
辐	輻
鳍	鰭
鲈	鱸
鲷	鯛
桡	橈
脚	腳
赏	賞
诚	誠
闹	鬧
赋	賦
裤	褲
缝	縫
饮	飲
枪	槍
腊	臘
虽	雖
压	壓
拥	擁
财	財
驱	驅
贡	貢
谊	誼
侠	俠
炮	砲
髅	髏
态	態
补	補
庞	龐
颂	頌
适	適
荡	盪
惩	懲
颁	頒
垦	墾
垫	墊
纤	纖
胶	膠
庐	廬
笋	筍
涌	湧
冲	沖
晒	曬
侬	儂
摇	搖
荠	薺
绮	綺
爷	爺
绑	綁
缙	縉
泸	瀘
枢	樞
台	臺
渔	漁
宾	賓
扰	擾
吨	噸
飞	飛
剥	剝
础	礎
韩	韓
忆	憶
肮	骯
脏	臟
挤	擠
盗	盜
沦	淪
浅	淺
坝	壩
执	執
盘	盤
尧	堯
担	擔
详	詳
炼	煉
杯	盃
蔷	薔
潇	瀟
吁	籲
孙	孫
赵	趙
雇	僱
佣	傭
奖	獎
虑	慮
劳	勞
毁	毀
桩	樁
迈	邁
狱	獄
贫	貧
粪	糞
篮	籃
储	儲
烧	燒
扎	紮
面	麵
松	鬆
灵	靈
纷	紛
咨	諮
询	詢
涨	漲
纯	純
矶	磯
贵	貴
软	軟
倾	傾
听	聽
绍	紹
绞	絞
脉	脈
痉	痙
挛	攣
毙	斃
念	唸
载	載
净	淨
绰	綽
铂	鉑
凤	鳳
柜	櫃
卖	賣
锣	鑼
鸣	鳴
贸	貿
筹	籌
悬	懸
钦	欽
钵	缽
债	債
悦	悅
涛	濤
滩	灘
狭	狹
稣	穌
骤	驟
娴	嫻
莲	蓮
赚	賺
诈	詐
贬	貶
谑	謔
愤	憤
寝	寢
蒋	蔣
聪	聰
颇	頗
托	託
谨	謹
尸	屍
块	塊
叙	敘
绣	綉
伟	偉
鲤	鯉
碍	礙
疟	瘧
萧	蕭
玮	瑋
琐	瑣
纸	紙
鸡	雞
韵	韻
抛	拋
药	藥
挂	掛
虚	虛
诊	診
髋	髖
页	頁
贩	販
镑	鎊
兑	兌
冯	馮
仑	崙
驾	駕
疖	癤
缔	締
厨	廚
绳	繩
输	輸
冈	岡
劝	勸
捡	撿
谓	謂
仅	僅
杆	桿
肠	腸
酿	釀
荐	薦
恼	惱
铎	鐸
错	錯
梦	夢
拨	撥
诠	詮
饭	飯
辩	辯
毡	氈
猎	獵
趋	趨
纭	紜
谢	謝
朴	樸
屿	嶼
盐	鹽
灿	燦
烂	爛
涩	澀
顷	頃
厢	廂
贞	貞
贴	貼
焰	燄
悫	愨
缘	緣
谦	謙
饱	飽
岭	嶺
浒	滸
鸽	鴿
饲	飼
胆	膽
兽	獸
刚	剛
跃	躍
妇	婦
泄	洩
欲	慾
御	禦
阇	闍
缴	繳
闸	閘
虏	虜
刍	芻
讽	諷
缠	纏
衔	銜
尘	塵
诱	誘
绪	緒
缓	緩
呕	嘔
耸	聳
祷	禱
颈	頸
阶	階
窑	窯
厂	廠
锐	銳
绅	紳
顾	顧
络	絡
懒	懶
凭	憑
荫	蔭
粤	粵
猪	豬
琼	瓊
致	緻
烦	煩
挣	掙
仓	倉
铭	銘
渎	瀆
锭	錠
韧	韌
夸	誇
税	稅
颉	頡
镛	鏞
挡	擋
艰	艱
赐	賜
诽	誹
谤	謗
惊	驚
娇	嬌
赔	賠
钱	錢
侨	僑
宠	寵
辉	輝
谄	諂
贤	賢
雕	鵰
坠	墜
泼	潑
逻	邏
账	帳
谣	謠
仆	僕
升	陞
椭	橢
谚	諺
秋	鞦
千	韆
勋	勳
狮	獅
绿	綠
宪	憲
栎	櫟
厮	廝
暂	暫
丛	叢
枫	楓
家	傢
婴	嬰
喷	噴
浑	渾
敛	斂
表	錶
寿	壽
虫	蟲
锷	鍔
滨	濱
轿	轎
觐	覲
锤	錘
萦	縈
蚂	螞
蚁	蟻
克	剋
坟	墳
赶	趕
踪	蹤
啸	嘯
阔	闊
叹	嘆
聋	聾
淀	澱
滞	滯
柠	檸
彦	彥
斩	斬
绯	緋
遥	遙
链	鏈
铲	剷
奸	姦
惭	慚
厌	厭
钧	鈞
洁	潔
铝	鋁
症	癥
壳	殼
陕	陝
效	効
挠	撓
妆	妝
杠	槓
钰	鈺
谁	誰
迟	遲
阀	閥
牍	牘
闷	悶
骐	騏
硕	碩
袜	襪
舱	艙
囱	囪
凿	鑿
梁	樑
撑	撐
禅	禪
浓	濃
缩	縮
铀	鈾
帐	帳
颜	顏
饼	餅
蚬	蜆
绎	繹
雾	霧
窜	竄
牵	牽
聂	聶
浊	濁
绀	紺
纾	紓
鲗	鰂
驳	駁
板	闆
步	歩
莹	瑩
鳉	鱂
伙	夥
炽	熾
殡	殯
芜	蕪
帜	幟
昵	暱
桨	槳
钛	鈦
炉	爐
赌	賭
灯	燈
谜	謎
锅	鍋
鸳	鴛
鸯	鴦
濒	瀕
舆	輿
猫	貓
羡	羨
峰	峯
骋	騁
窝	窩
颚	顎
饥	饑
涂	塗
珐	琺
龋	齲
辙	轍
躯	軀
笼	籠
驯	馴
饿	餓
茎	莖
芦	蘆
睿	叡
晔	曄
𫓧	鈇
镭	鐳
讶	訝
搅	攪
闯	闖
萤	螢
脸	臉
蛎	蠣
鲍	鮑
闪	閃
穷	窮
挚	摯
骏	駿
锻	鍛
焘	燾
诅	詛
泪	淚
颊	頰
吗	嗎
蜡	蠟
烛	燭
浏	瀏
览	覽
绒	絨
铵	銨
疱	皰
贱	賤
贻	貽
窃	竊
鳃	鰓
鲹	鰺
站	駅
伪	偽
骚	騷
镍	鎳
锌	鋅
贾	賈
钻	鑽
鹏	鵬
烃	烴
纬	緯
捞	撈
颓	頹
陨	隕
镁	鎂
馏	餾
锈	銹
鳞	鱗
凶	兇
瘾	癮
舍	捨
腾	騰
赎	贖
壶	壺
暧	曖
镖	鏢
娅	婭
掴	摑
仿	彷
佛	彿
睐	睞
觅	覓
赁	賃
诙	詼
谐	諧
铅	鉛
筝	箏
轧	軋
驸	駙
颢	顥
畴	疇
笃	篤
携	攜
饷	餉
铸	鑄
钊	釗
叠	疊
缭	繚
阐	闡
瓯	甌
诰	誥
诏	詔
麸	麩
茧	繭
谎	謊
了	瞭
罚	罰
渗	滲
钏	釧
绵	綿
锯	鋸
缆	纜
纠	糾
曲	麴
巅	巔
顽	頑
拦	攔
辍	輟
牺	犧
谍	諜
向	嚮
鸭	鴨
骂	罵
谅	諒
驰	馳
搜	蒐
践	踐
耻	恥
尴	尷
飚	飈
鹃	鵑
夹	夾
沧	滄
馍	饃
渍	漬
阎	閻
你	妳
肿	腫
竖	豎
渊	淵
侦	偵
桧	檜
堕	墮
葱	蔥
蜗	蝸
娄	婁
烨	燁
龟	龜
卷	捲
闽	閩
畅	暢
咙	嚨
祎	禕
绥	綏
钉	釘
纱	紗
鲸	鯨
侄	姪
哗	嘩
脐	臍
郁	鬱
鞑	韃
诵	誦
胀	脹
锛	錛
槟	檳
砖	磚
缉	緝
赉	賚
馅	餡
饺	餃
谌	諶
荆	荊
谒	謁
讷	訥
谭	譚
查	査
𪢠	囒
鹰	鷹
钩	鉤
歼	殲
纨	紈
删	刪
骧	驤
搁	擱
轩	軒
辕	轅
闰	閏
酱	醬
驴	驢
帧	幀
𫚭	鱲
沥	瀝
垩	堊
讳	諱
俪	儷
缀	綴
讣	訃
弯	彎
谥	謚
钥	鑰
讫	訖
滥	濫
𬣞	詝
蝉	蟬
骥	驥
秘	祕
缤	繽
鬓	鬢
铨	銓
泾	涇
辗	輾
坞	塢
搭	撘
镶	鑲
谕	諭
抵	牴
缎	緞
揽	攬
讼	訟
腻	膩
颖	穎
鸦	鴉
糖	醣
唠	嘮
鹌	鵪
鹑	鶉
饪	飪
捣	搗
疡	瘍
钞	鈔
鳕	鱈
局	侷
刮	颳
诟	詬
觊	覬
觎	覦
瘫	癱
痪	瘓
昆	崑
厉	厲
缪	繆
崭	嶄
谛	諦
馈	饋
驼	駝
铗	鋏
涟	漣
咸	鹹
驮	馱
骆	駱
悯	憫
诡	詭
缕	縷
晕	暈
出	齣
濑	瀨
润	潤
啰	囉
谏	諫
咏	詠
贷	貸
雳	靂
折	摺
纥	紇
掷	擲
埙	塤
颐	頤
鳗	鰻
鲡	鱺
合	閤
累	纍
修	脩
栅	柵
缮	繕
扫	掃

